%%%%%%
% ...%
% %%.%
% %%.%
%.P .%
%.%%%%
%...G%
%%%%%%